border_size=1
usage=map

Xu          , Xuc         , Xu          , Xuc         , Xuc         , Xuc         , Xuc         , Xuc         , Xuc         , Xuc         , Xuc         , Xuc         , Xuc         , Xuc         , Xuc         , Xuc         , Xuc         , Xuc         , Xuc         , Xuc         , Xuc         , Xuc         , Xuc         , Xuc         , Xuc         , Xuc         , Xuc         , Xuc         , Xuc         , Xuc         , Xuc         , Xuc         , Xu          , Xu          , Xu          , Xu          , Xu          , Xu          , Xu          , Xu          , Xu          , Xu          , Xu          , Xu          
Xu          , Xu          , Xu          , Xuc         , Xuc         , Xuc         , Xuc         , Xuc         , Xuc         , Xuc         , Xuc         , Xuc         , Xuc         , Xuc         , Xuc         , Xuc         , Cud         , Xuc         , Uu          , Xuc         , Xuc         , Xuc         , Xuc         , Xuc         , Xuc         , Xuc         , Xuc         , Xuc         , Xuc         , Xuc         , Xuc         , Xuc         , Xu          , Xu          , Xu          , Xu          , Xu          , Xu          , Xu          , Xu          , Xu          , Xu          , Xu          , Xu          
Xu          , Xu          , Xu          , Xu          , Uh          , Uh          , Uh          , Uh          , Uh          , Uh          , Uu          , Xuc         , Xuc         , Xuc         , Cud         , 1 Kud       , Cud         , Cud         , Uu          , Xuc         , Xuc         , Xuc         , Xuc         , Xuc         , Uh          , Xuc         , Uh          , Uh          , Uu          , Uu          , Uu          , Uu^Uf       , Uu^Uf       , Xu          , Xu          , Xu          , Xu          , Xu          , Xu          , Xu          , Xu          , Xu          , Xu          , Xu          
Xu          , Xu          , Uh          , Uh          , Uh          , Uh          , Uh          , Uh          , Uh          , Uh          , Uu          , Uu          , Uu          , Uu          , Cud         , Cud         , Uu          , Urb         , Urb         , Uu^Vud      , Xuc         , Xuc         , Xuc         , Uh          , Uh          , Uh          , Uh          , Uh          , Uu          , Uu          , Uu^Uf       , Uu^Uf       , Uu^Uf       , Uu^Uf       , Xu          , Xu          , Xu          , Xu          , Xu          , Xu          , Xu          , Xu          , Uu          , Xu          
Xu          , Xu          , Uu          , Uu          , Uu          , Uu          , Uu          , Uh          , Uu^Es       , Uu          , Uu          , Uu          , Urb         , Urb         , Uu          , Uu^Uf       , Uu          , Uu          , Uu          , Urb         , Uu          , Xuc         , Uu          , Uh          , Uh          , Uh          , Uu          , Uu          , Uu          , Uu          , Uu          , Uu^Uf       , Uu          , Uu^Uf       , Xu          , Xu          , Xu          , Xu          , Xu          , Uh          , Uh          , Uh          , Uu          , Uu          
Xu          , Xu          , Uu          , Uu          , Uu^Vu       , Uu          , Uu          , Uu          , Uu          , Uu          , Uu^Emf      , Uu^Vu       , Urb         , Uu          , Uu          , Uu          , Xuc         , Uu          , Uu          , Urb         , Urb         , Uu          , Uu^Es       , Uu          , Uu          , Uu          , Uu          , Uu^Vu       , Urb         , Uu          , Uu          , Uu          , Uu          , Uu          , Uu^Uf       , Xu          , Uh          , Uh          , Uh          , Uh          , Uu          , Uh          , Uu          , Uu          
Xu          , Uu^Uf       , Uu          , Uu          , Uu          , Urb         , Urb         , Uu          , Uu          , Uu          , Urb         , Urb         , Uu          , Uu          , Xuc         , Xuc         , Xuc         , Xuc         , Uu^Uf       , Uu          , Uu          , Urb         , Urb         , Uu          , Uu          , Uu^Uf       , Urb         , Urb         , Uu          , Urb         , Urb         , Uu          , Uu          , Uu          , Uu          , Uu          , Uu^Vu       , Uu          , Uu          , Uu          , Uu          , Uu          , Uu          , Uu          
Xu          , Uu          , Uu          , Uu          , Uu          , Uu          , Uu          , Urb         , Cud         , Urb         , Uu          , Uu          , Uu          , Uu^Es       , Uh          , Xuc         , Xuc         , Xuc         , Uh          , Uu          , Uu          , Uu^Emf      , Urb         , Uu          , Urb         , Urb         , Uu          , Uu          , Uu          , Uu          , Uu          , Urb         , Urb         , Uu^Vu       , Urb         , Urb         , Uu          , Uu          , Uu          , Uu          , Ce          , Ce          , Ce          , Uu          
Xu          , Uu          , Uu          , Uu          , Uu          , Uu          , Cud         , Cud         , Cud         , Uu          , Urb         , Uu          , Uu          , Uu          , Uh          , Xuc         , Uh          , Uh          , Uh          , Uu          , Urb         , Uu^Vu       , Urb         , Urb         , Uu          , Uu          , Uu          , Uu^Em       , Uu          , Uu          , Qxu         , Uu          , Uu          , Urb         , Urb         , Uu^Em       , Uu          , Uu          , Urb         , Ce          , Ce          , 3 Ke        , Ce          , Uu          
Xu          , Uu          , Uu          , Uu          , Uu          , Uu          , Cud         , 2 Kud       , Cud         , Cud         , Uu          , Urb         , Urb         , Urb         , Urb         , Uh          , Uh          , Uh          , Urb         , Urb         , Uu          , Urb         , Uu          , Uu          , Uu          , Uu          , Xu          , Uu          , Uu^Es       , Qxu         , Qxu         , Qxu         , Urb         , Uu          , Urb         , Uu          , Urb         , Urb         , Uu^Uf       , Ce          , Ce          , Ce          , Ce          , Urb         
Xu          , Xu          , Uu          , Uu          , Uu          , Uu          , Urb         , Cud         , Uu          , Uu^Uf       , Uu          , Uu          , Uu          , Uu^Vu       , Uu^Emf      , Urb         , Urb         , Urb         , Uu^Em       , Uu          , Uu          , Uu          , Uu          , Uu          , Uu^Uf       , Xu          , Xu          , Uu          , Uu          , Uu          , Urb         , Qxu^Bs/     , Urb         , Urb         , Uu^Vu       , Urb         , Uu          , Uu          , Uu          , Uu          , Uu          , Ce          , Uu          , Uu          
Xu          , Xu          , Uu          , Uu          , Uu^Vud      , Urb         , Uu          , Uu          , Uu          , Uu          , Uu          , Uu          , Uu          , Uu          , Uu          , Uu          , Uu          , Urb         , Urb         , Uu          , Uu          , Uu          , Uu          , Uu          , Urb         , Uu          , Uu          , Uu          , Urb         , Urb         , Qxu         , Qxu         , Uu          , Uu          , Uu          , Uu^Uf       , Uu          , Uu          , Uu^Es       , Uu          , Uu          , Uu          , Uu          , Uu          
Xu          , Uu          , Uu          , Uu          , Uu          , Uu^Emf      , Uu          , Uu          , Uu          , Xu          , Xu          , Uu          , Uu^Uf       , Uu          , Xuc         , Uu          , Uu          , Uu          , Uu          , Urb         , Urb         , Urb         , Urb         , Urb         , Uu^Uf       , Urb         , Urb         , Urb         , Uu          , Uu          , Qxu         , Qxu         , Uu          , Uu          , Uu          , Uu          , Uh          , Uu          , Uu          , Uu          , Uu          , Uu          , Uu          , Uu          
Xu          , Uu^Uf       , Xu          , Uu          , Uu          , Uu          , Uu          , Uu          , Uu          , Xu          , Xu          , Xu          , Xuc         , Xuc         , Xuc         , Xuc         , Uu          , Uu          , Uu          , Uu          , Uu          , Uu^Vu       , Uu^Emf      , Uu          , Uu          , Uu          , Uu          , Uu^Vu       , Uu          , Uu          , Qxu         , Qxu         , Qxu         , Xu          , Xu          , Xu          , Xu          , Uh          , Uh          , Uh          , Uu          , Uu          , Xu          , Xu          
Xu          , Xu          , Xuc         , Uu          , Uu          , Uu          , Uu          , Uu          , Uu          , Uu^Uf       , Xuc         , Xu          , Xuc         , Xuc         , Xuc         , Xuc         , Xuc         , Uu^Es       , Xuc         , Uu          , Uu          , Uu          , Uu          , Uu          , Uu          , Uu          , Uu          , Uu          , Uu          , Uu          , Qxu         , Qxu         , Qxu         , Xu          , Xu          , Xu          , Xu          , Uh          , Uh          , Uh          , Xu          , Uu^Uf       , Uu^Uf       , Xu          
Xuc         , Xuc         , Xuc         , Xuc         , Xuc         , Xuc         , Xuc         , Xuc         , Xuc         , Xuc         , Xuc         , Xuc         , Xuc         , Xuc         , Xuc         , Xuc         , Xuc         , Xuc         , Xuc         , Xuc         , Xuc         , Uu^Em       , Xuc         , Xuc         , Xuc         , Xuc         , Xuc         , Xuc         , Xuc         , Xuc         , Qxu         , Qxu         , Qxu         , Xu          , Xu          , Xu          , Xu          , Xu          , Xu          , Xu          , Xu          , Xu          , Xu          , Xu          
Xuc         , Xuc         , Xuc         , Xuc         , Xuc         , Xuc         , Xuc         , Xuc         , Xuc         , Xuc         , Xuc         , Xuc         , Xuc         , Xuc         , Xuc         , Xuc         , Xuc         , Xuc         , Xuc         , Xuc         , Xuc         , Xuc         , Xuc         , Xuc         , Xuc         , Xuc         , Xuc         , Xuc         , Xuc         , Qxu         , Qxu         , Qxu         , Qxu         , Qxu         , Xu          , Xu          , Xu          , Xu          , Xu          , Xu          , Xu          , Xu          , Xu          , Xu          
