border_size=1
usage=map

Uu          , Uu          , Uu          , Uu          , Uu          , Uu          , Uu          , Xu          , Xu          , Xu          , Xu          , Xu          , Xu          , Xu          , Xu          , Xu          , Xu          , Xu          , Ql          , Ql          , Ql          , Ql          , Ql          , Ql          , Ql          , Uu          , Uu          , Uu          , Xu          , Xu          , Xu          , Xu          , Xu          , Xu          , Xu          , Xu          , Xu          , Xu          , Xu          , Xu          , Xu          , Xu          , Xu          , Xu          , Xu          , Xu          , Xu          , Xu          , Xu          , Xu          , Xu          , Xu          
Uu          , Uu          , Uu          , Uu          , Uu          , Uu^Em       , Uu          , Uu          , Uu          , Xu          , Xu          , Xu          , Xu          , Xu          , Xu          , Xu          , Xu          , Xu          , Xu          , Ql          , Ql          , Ql          , Ql          , Ql          , Ql          , Uu          , Uu          , Uu          , Xu          , Xu          , Xu          , Xu          , Xu          , Xu          , Xu          , Xu          , Xu          , Xu          , Xu          , Xu          , Xu          , Xu          , Xu          , Xu          , Xu          , Xu          , Xu          , Xu          , Xu          , Xu          , Xu          , Xu          
Uu          , Uu          , Uu^Emf      , Uu          , Uu          , Uu          , Ce          , Uu          , Uu          , Uu^Uf       , Xu          , Xu          , Uu          , Xu          , Xu          , Xu          , Xu          , Xu          , Xu          , Ql          , Ql          , Ql          , Ql          , Ql          , Uu          , Uu          , Uu          , Uu          , Xu          , Xu          , Xu          , Xu          , Xu          , Xu          , Xu          , Xu          , Xu          , Xu          , Xu          , Xu          , Xu          , Xu          , Xu          , Xu          , Xu          , Xu          , Xu          , Xu          , Xu          , Xu          , Xu          , Xu          
Uu          , Uu          , Uu^Vu       , Uu          , Uu          , Ce          , 5 Ke        , Ce          , Uu          , Uu          , Uu          , Uu          , Uu          , Uu          , Uu          , Uu^Uf       , Uu          , Xu          , Xu          , Xu          , Xu          , Xu          , Xu          , Uu          , Uu          , Uu          , Uu          , Xu          , Xu          , Xu          , Xu          , Xu          , Xu          , Xu          , Xu          , Xu          , Xu          , Xu          , Xu          , Xu          , Xu          , Xu          , Xu          , Xu          , Xu          , Xu          , Xu          , Xu          , Xu          , Xu          , Xu          , Xu          
Uu          , Uu          , Uu          , Uu          , Uu          , Ce          , Ce          , Ce          , Uu          , Uu          , Uu          , Uu          , Uu          , Uu          , Uu^Em       , Uu          , Uu          , Uu          , Ce          , Uu          , Uu          , Xu          , Uu          , Uu          , Uu          , Uu          , Uu          , Xu          , Xu          , Xu          , Xu          , Xu          , Xu          , Xu          , Xu          , Xu          , Xu          , Xu          , Xu          , Xu          , Xu          , Xu          , Xu          , Xu          , Uu^Uf       , Xu          , Uu^Uf       , Uu^Uf       , Xu          , Xu          , Xu          , Xu          
Xu          , Uu          , Xu          , Uu          , Uu          , Uu          , Uu          , Uu          , Uu          , Uu          , Uu          , Uu^Vud      , Uu^Br/      , Uu^Br/      , Uu^Br\      , Uu          , Uu          , Ce          , 3 Ke        , Ce          , Uu          , Uu          , Uu          , Uu          , Uu          , Uu          , Xu          , Xu          , Xu          , Xu          , Xu          , Xu          , Uu          , Xu          , Uu          , Uu^Emf      , Uu          , Xu          , Xu          , Xu          , Xu          , Xu          , Xu          , Xu          , Uu^Emf      , Uu^Emf      , Uu^Emf      , Uu^Uf       , Xu          , Xu          , Xu          , Xu          
Xu          , Xu          , Xu          , Xu          , Uu          , Uu          , Uu          , Uu          , Uu          , Uu^Em       , Uu^Br/      , Uu^Br/      , Uu          , Uu          , Uu          , Uu^Br\      , Uu^Br\      , Ce          , Ce          , Ce          , Uu          , Uu          , Uu          , Uu          , Uu          , Xu          , Xu          , Xu          , Xu          , Xu          , Xu          , Xu          , Uu          , Uu          , Uu          , Uu^Em       , Uu          , Xu          , Xu          , Xu          , Uu          , Xu          , Uu          , Xu          , Uu          , Uu          , Uu          , Uu^Emf      , Xu          , Xu          , Xu          , Xu          
Xu          , Xu          , Xu          , Xu          , Uu          , Uu          , Uu          , Uu          , Uu^Br/      , Uu^Br/      , Uu          , Uu          , Xu          , Uu          , Uu          , Uu          , Uu          , Uu^Br\      , Uu^Br\      , Uu          , Uu          , Uu^Em       , Uu          , Uu          , Uu          , Uu^Uf       , Xu          , Xu          , Xu          , Xu          , Xu          , Uu^Uf       , Uu          , Uu          , Uu          , Uu          , Uu          , Uu          , Uu          , Uu          , Uu          , Uu          , Uu          , Uu          , Uu          , Uu          , Uu          , Xu          , Xu          , Xu          , Xu          , Xu          
Xu          , Xu          , Xu          , Xu          , Uu          , Uu          , Uu          , Uu^Br|      , Uu          , Uu^Vu       , Uu^Emf      , Uu          , Xu          , Xu          , Xu          , Xu          , Xu          , Uu          , Uu          , Uu^Br\      , Uu^Br\      , Uu          , Uu          , Uu^Vu       , Uu          , Uu          , Uh          , Xu          , Xu          , Xu          , Uh          , Uh          , Uu^Vud      , Uu          , Uu          , Uu^Em       , Uu          , Uu^Emf      , Uu^Vu       , Uu          , Uu          , Uu          , Uu          , Uu          , Uu          , Uu          , Uu          , Uu          , Uu          , Xu          , Xu          , Xu          
Xu          , Xu          , Xu          , Xu          , Xu          , Uu          , Uu          , Uu^Br|      , Uu          , Uu          , Uu          , Uu          , Uu          , Xu          , Xu          , Xu          , Xu          , Uu^Uf       , Uu          , Uu          , Uu          , Uu^Br\      , Uu^Br\      , Uu          , Uu          , Uu          , Uu          , Uh          , Uh^Em       , Uh          , Uu^Br/      , Uu^Br/      , Ur          , Uu          , Uu          , Uu          , Uu          , Uu          , Uu          , Uu          , Uu          , Uu          , Uu^Emf      , Uu          , Uu          , Uu          , Uu          , Uu          , Xu          , Xu          , Xu          , Xu          
Xu          , Xu          , Xu          , Xu          , Xu          , Uu          , Uu          , Uu^Br|      , Uu          , Uu          , Uu          , Uu          , Uu          , Xu          , Xu          , Xu          , Xu          , Uu^Uf       , Xu          , Uu          , Uu          , Uu          , Uu          , Uu^Br\      , Uu^Br\      , Uu          , Uu          , Uh          , Uu^Br/      , Uu^Br/      , Uh          , Ur          , Uu          , Uu          , Uu          , Uu          , Uu          , Uu          , Uu          , Uu          , Uu          , Uu          , Ur          , Uu^Vu       , Uu          , Uu          , Uu          , Xu          , Xu          , Xu          , Xu          , Xu          
Xu          , Xu          , Xu          , Xu          , Xu          , Uu          , Uu          , Uu^Br|      , Uu          , Uu          , Uu          , Uu          , Uu^Uf       , Xu          , Xu          , Xu          , Xu          , Xu          , Xu          , Xu          , Xu          , Xu          , Xu          , Uu          , Uu          , Uu^Br\      , Uu^Br\      , Uu^Br/      , Uh          , Uh          , Uh          , Ur          , Uu          , Uu          , Uu^Uf       , Uu          , Uu          , Uu          , Uu^Emf      , Uu          , Ur          , Ur          , Uu          , Uu          , Ce          , Uu          , Uu          , Xu          , Xu          , Xu          , Xu          , Xu          
Xu          , Xu          , Xu          , Xu          , Xu          , Uu          , Uu          , Uu^Vud      , Ur          , Uu          , Uu          , Uu          , Xu          , Xu          , Xu          , Xu          , Xu          , Xu          , Xu          , Xu          , Xu          , Xu          , Xu          , Uu          , Uu          , Uu          , Uu          , Uh          , Uh          , Uh          , Uu^Uf       , Ur          , Uu          , Uu          , Uu          , Uu          , Uu          , Uu^Vu       , Ur          , Ur          , Uu          , Uu          , Uu          , Ce          , 1 Ke        , Ce          , Uu          , Uu^Vu       , Xue         , Xu          , Xu          , Xu          
Xu          , Xu          , Xu          , Xu          , Xu          , Uu          , Uu          , Uu          , Ur          , Ur          , Ur          , Uu          , Uu          , Xu          , Xu          , Xu          , Xu          , Xu          , Uu          , Xu          , Xu          , Xu          , Xu          , Uu          , Uu^Em       , Uu          , Uh          , Uh          , Uh          , Uh          , Uh          , Ur          , Ur          , Uu          , Ur          , Uu          , Ur          , Ur          , Uu          , Uu          , Ce          , Uu          , Uue         , Ce          , Ce          , Ce          , Uue         , Uue         , Xue         , Xu          , Xu          , Xu          
Xu          , Xu          , Xu          , Xu          , Xu          , Uu          , Ur          , Ur          , Ur          , Ur          , Ur          , Ur          , Ur          , Xu          , Xu          , Xu          , Uu          , Uu          , Uu          , Uu          , Uu          , Xu          , Xu          , Uu          , Uu          , Uu          , Uh          , Uh          , Uh^Em       , Uh          , Uu          , Uu^Vu       , Uu          , Ur          , Uu          , Ur          , Uu^Vu       , Uu          , Uu          , Ce          , 2 Ke        , Ce          , Uue         , Uue         , Uue         , Uue         , Xue         , Uue         , Xue         , Xu          , Xue         , Xue         
Xu          , Xu          , Xu          , Xu          , Xu          , Xu          , Uu          , Ur          , Ce          , Ce          , Ce          , Ur          , Ur          , Ur          , Uu          , Uu          , Uu          , Uu          , Uu^Vu       , Uu^Emf      , Ur          , Ur          , Ur          , Uu          , Uu          , Uu          , Uu          , Uh          , Uh          , Uh          , Uh          , Uu          , Uu          , Uu^Em       , Uu          , Uu          , Uu^Emf      , Uu          , Uu          , Ce          , Ce          , Ce          , Uue         , Uue         , Uue         , Uue         , Xue         , Xue         , Xue         , Xue         , Uue         , Uue         
Xu          , Xu          , Xu          , Xu          , Xu          , Xu          , Uu          , Ur          , Ce          , 4 Ke        , Ce          , Ur          , Ur          , Ur          , Uu          , Uu          , Uu          , Ur          , Ur          , Ur          , Ur          , Ur          , Ur          , Ur          , Ur          , Uu          , Uu          , Uu          , Uh          , Uh          , Uh          , Uh          , Xu          , Uu          , Uu          , Uu          , Uu          , Uu          , Uu^Vu       , Uu          , Uu          , Uu          , Xu          , Xu          , Xue         , Uue         , Xue         , Xue         , Uue         , Uu^Ufi      , Wwg         , Wwg         
Xu          , Xu          , Xu          , Xu          , Xu          , Xu          , Uu          , Ur          , Ur          , Ce          , Ur          , Ur          , Ur          , Ur          , Ur          , Uu          , Ur          , Ur          , Ur          , Uu          , Uu          , Uu          , Uu          , Ur          , Uu          , Uu^Vu       , Uu          , Uu          , Uh          , Uh^Em       , Uh          , Xu          , Xu          , Xu          , Uu^Uf       , Uu          , Uu          , Uu          , Uu          , Uu          , Xu          , Uu          , Xu          , Xue         , Uue^Em      , Uue         , Uue         , Uue^Efm     , Wwg         , Wwg         , Wog         , Wog         
Xu          , Xu          , Xu          , Xu          , Xu          , Xu          , Uu          , Ur          , Ur          , Ur          , Ur          , Ur          , Ur          , Ur          , Ur          , Ur          , Ur          , Ur          , Uu          , Uu          , Uue         , Uu          , Uue         , Uu          , Uu^Uf       , Uu          , Uu          , Uu          , Uh          , Uh          , Xu          , Xu          , Xu          , Xu          , Xu          , Uu          , Uu          , Uu          , Uu          , Uu          , Xu          , Xu          , Xue         , Xue         , Uue         , Uue         , Uue^Ii      , Wwg         , Wog         , Wwg         , Wog         , Wog         
Xu          , Xu          , Xu          , Xu          , Xu          , Xu          , Uu          , Uu          , Uu          , Uu          , Uu          , Ur          , Uu          , Uu^Vud      , Ur          , Ur          , Ur          , Uu          , Uu          , Uue         , Uue^Em      , Uue         , Xue         , Uue         , Xu          , Xu          , Xu          , Uu          , Xu          , Xu          , Xu          , Xu          , Xu          , Xu          , Xu          , Uu          , Xu          , Xu          , Xu          , Xu          , Xu          , Xue         , Uue         , Uue         , Wwg         , Uue         , Wog         , Wog         , Wog         , Wog         , Wog         , Wog         
Xu          , Xu          , Xu          , Xu          , Xu          , Xu          , Xu          , Uu          , Uu          , Uu          , Uu          , Uu^Em       , Uu          , Uu          , Uu          , Ur          , Uu          , Uu          , Uu          , Uue         , Uue         , Uue         , Xue         , Xu          , Xu          , Xu          , Xu          , Xu          , Xu          , Xu          , Xu          , Xu          , Xu          , Xu          , Xu          , Xu          , Xu          , Xu          , Xu          , Xu          , Xu          , Xue         , Uue         , Uue^Ii      , Wwg         , Wwg         , Wog         , Wog         , Wog         , Wog         , Wog         , Wog         
Xu          , Xu          , Xu          , Xu          , Xu          , Xu          , Xu          , Xu          , Uu          , Uu          , Uu          , Uu          , Uu          , Uu          , Uu          , Uu          , Uu          , Uu          , Uu          , Uue         , Xue         , Xue         , Xu          , Xu          , Xu          , Xu          , Xu          , Xu          , Xu          , Xu          , Xu          , Xu          , Xu          , Xu          , Xu          , Xu          , Xu          , Xu          , Xu          , Xu          , Xu          , Xue         , Wwg         , Wwg         , Wwg         , Wwg         , Wog         , Wog         , Wog         , Wog         , Wwg         , Wwg         
Xu          , Xu          , Xu          , Xu          , Xu          , Xu          , Xu          , Xu          , Xu          , Uu          , Xu          , Uu          , Uu          , Uu          , Uu          , Uu          , Uu          , Uu          , Uu          , Uu          , Uu          , Xu          , Xu          , Xu          , Xu          , Xu          , Xu          , Xu          , Xu          , Xu          , Xu          , Xu          , Xu          , Xu          , Xu          , Xu          , Xu          , Xu          , Xu          , Xu          , Xu          , Xue         , Uue^Efm     , Wwg         , Wwg         , Wog         , Wog         , Wog         , Wog         , Wog         , Wwg         , Wwg         
Xu          , Xu          , Xu          , Xu          , Xu          , Xu          , Xu          , Xu          , Xu          , Xu          , Xu          , Xu          , Xu          , Xu          , Xu          , Xu          , Xu          , Uu          , Uu          , Uu          , Xu          , Xu          , Xu          , Xu          , Xu          , Xu          , Xu          , Xu          , Xu          , Xu          , Xu          , Xu          , Xu          , Xu          , Xu          , Xu          , Xu          , Xu          , Xu          , Xu          , Xu          , Xue         , Uue         , Wwg         , Wwg         , Wog         , Wog         , Wog         , Wog         , Wwg         , Uu^Ufi      , Uu^Ufi      
Xu          , Xu          , Xu          , Xu          , Xu          , Xu          , Xu          , Xu          , Xu          , Xu          , Xu          , Xu          , Xu          , Xu          , Xu          , Xu          , Xu          , Xu          , Xu          , Xu          , Xu          , Xu          , Xu          , Xu          , Xu          , Xu          , Xu          , Xu          , Xu          , Xu          , Xu          , Xu          , Xu          , Xu          , Xu          , Xu          , Xu          , Xu          , Xu          , Xu          , Xu          , Xue         , Uue         , Uu^Ufi      , Wwg         , Wwg         , Wog         , Wog         , Wog         , Wwg         , Uu^Ufi      , Uu^Ufi      
