border_size=1
usage=map

Gg          , Gg          , Gg          , Gg          , Gg          , Gg          , Gg          , Gg          , Gg          , Gg          , Gg          , Gg          , Rrc         , Rrc         , Rrc         , Gg          , Gg          , Gd          , Gd          , Hhd         , Hhd         , Hhd         , Hhd         , Hhd         , Md          , Md          , Md          
Gg          , Gg          , Gg          , Gg          , Gg          , Gg          , Gg          , Gg          , Gg          , Gg          , Gg          , Gg          , Rrc         , Rrc         , Rrc         , Gg          , Gg          , Gd          , Gd          , Gd          , Gd          , Hhd         , Hhd         , Hhd         , Md          , Md          , Md          
Gg          , Gg          , Gg          , Gg          , Gg          , Gg          , Gg          , Gs^Fds      , Gs^Fds      , Gg^Ve       , Gg          , Gg          , Rrc         , Rrc         , Rrc         , Gg          , Gg          , Gg^Ve       , Gs^Fds      , Gs^Fds      , Gd          , Gd          , Hhd         , Hhd         , Md          , Md          , Md          
Gg          , Gg          , Gg          , Gg          , Ww          , Gg          , Gg          , Gs^Fds      , Gs^Fds      , Cv          , Cv          , Gg^Ve       , Cv          , Cv          , Cv          , Gg^Ve       , Cv          , Cv          , Gs^Fds      , Gs^Fds      , Gd          , Gd          , Hhd         , Hhd         , Md          , Md          , Md          
Gg          , Gg          , Ww          , Ww          , Wo          , Ww          , Gg          , Gs^Fds      , Gs^Fds      , Gs^Fds      , Cv          , Cv          , Cv          , 3 Kv        , Cv          , Cv          , Cv          , Gs^Fds      , Gs^Fds      , Gs^Fds      , Gd          , Hhd         , Hhd         , Hhd         , Md          , Md          , Mm          
Gg          , Gg          , Ww          , Wo          , Wo          , Gg          , Gg          , Gs^Fds      , Gs^Fds      , Cv          , Gs^Fds      , Gs^Fds      , Rp          , Cv          , Rp          , Gs^Fds      , Gs^Fds      , Cv          , Gs^Fds      , Gs^Fds      , Gd          , Hhd         , Mm          , Mm          , Md          , Md          , Md          
Gg          , Ww          , Ww          , Wo          , Wo          , Ww          , Gg          , Gs^Fds      , Gs^Fds      , Gs^Fds      , Gs^Fds      , Gs^Fds      , Rp          , Rp          , Rp          , Gs^Fds      , Gs^Fds      , Gs^Fds      , Gs^Fds      , Gs^Fds      , Gd          , Gd          , Mm          , Mm          , Mm          , Md          , Mm          
Gg          , Gg          , Gg          , Ww          , Ww          , Ww          , Gg          , Gg          , Gg          , Gs^Fds      , Gg          , Gg          , Gg          , Rp          , Gg          , Gg          , Gg          , Gs^Fds      , Hh          , Hh          , Mm          , Gd          , Mm          , Mm          , Mm          , Mm          , Mm          
Gg          , Gg          , Gg          , Gg          , Ww          , Ww          , Wo          , Gg          , Ww          , Gg          , Gg^Ve       , Gg          , Gg          , Rp          , Rp          , Gg          , Gg          , Gg          , Hh          , Hh          , Mm          , Mm          , Mm          , Mm          , Mm          , Mm          , Mm          
Gg          , Gg          , Gg          , Gg          , Gd^Vhr      , Ww          , Wo          , Wo          , Wo          , Ww          , Ww          , Gg          , Gg          , Gg          , Gg          , Rp          , Gg          , Gg          , Mm          , Mm          , Mm          , Mm          , Gs^Fms      , Mm          , Gs^Fms      , Mm          , Mm          
Gg          , Gg          , Gg          , Gg          , Gg          , Ww          , Gg          , Ww          , Ww          , Ww          , Gg          , Gg          , Gg          , Gg          , Gg          , Rp          , Gg^Ve       , Hh          , Hh          , Hh          , Gs^Fms      , Gs^Fms      , Gs^Fms      , Gs^Fms      , Gs^Fms      , Mm          , Mm          
Gg          , Gg          , Gg          , Gg          , Gg          , Gg          , Gg          , Gg          , Gg          , Gg          , Gg          , Gg          , Rp          , Gg          , Rp          , Rp          , Gg          , Hh          , Gs^Fms      , Hh          , Gs^Fms      , Gs^Fms      , Hh^Fds      , Hh^Fds      , Hh^Fds      , Gs^Fms      , Gs^Fms      
Gg          , Gg          , Chr         , Gg          , Chr         , Chr         , Chr         , Gg          , Rp          , Gg          , Rp          , Rp          , Gs^Fms      , Rp          , Gg          , Gg          , Gs^Fms      , Gg          , Gs^Fms      , Gs^Fms      , Gs^Fms      , Gs^Fms      , Gs^Fms      , Hh^Fds      , Hh^Fds      , Gs^Fms      , Gs^Fms      
Gg^Fet      , Gg          , Gs^Fms      , Chr         , Chr         , Khr         , Chr         , Rp          , Gs^Fms      , Rp          , Rp          , Gs^Fms      , Gs^Fms      , Gs^Fms      , Gs^Fms      , Gs^Fms      , Hh^Fds      , Gs^Fms      , Gs^Fms      , Gs^Fms      , Gs^Fms      , Gs^Fms      , Gs^Fms      , Gs^Fms      , Hh^Fds      , Hh^Fds      , Gs^Fms      
Gs^Fms      , Gs^Fms      , Gs^Fms      , Gs^Fms      , Gs^Fms      , Chr         , Gs^Fms      , Gs^Fms      , Gs^Fms      , Gs^Fms      , Rp          , Gs^Fms      , Gs^Fms      , Hh^Fds      , Hh^Fds      , Hh^Fds      , Hh^Fds      , Hh^Fds      , Hh          , Gs^Fms      , Gd^Vhr      , Gg^Fet      , Gg^Fet      , Gs^Fms      , Gs^Fms      , Hh^Fds      , Gs^Fms      
Gs^Fms      , Gs^Fms      , Gs^Fms      , Hh^Fds      , Hh^Fds      , Gs^Fms      , Gs^Fms      , Hh^Fms      , Gs^Fds      , Gs^Fms      , Rp          , Gs^Fms      , Gs^Fms      , Gs^Fms      , Gs^Fms      , Hh^Fds      , Hh          , Hh^Fds      , Hh          , Gg^Fet      , Gs^Fms      , Gg          , Gs^Fms      , Gs^Fms      , Gs^Fms      , Gs^Fms      , Gs^Fms      
Hh          , Gs^Fms      , Hh          , Hh^Fds      , Gs^Fms      , Gs^Fms      , Gs^Fms      , Gs^Fds      , Gs^Fms      , Gs^Fms      , Gs^Fms      , Rp          , Rp          , Gs^Fms      , Gs^Fms      , Gs^Fms      , Hh          , Hh          , Hh          , Gs^Fms      , Gs^Fds      , Gs^Fms      , Gs^Fms      , Gs^Fms      , Gs^Fds      , Gs^Fds      , Gs^Fms      
Hh          , Hh          , Hh          , Hh          , Gg          , Gd^Vhr      , Gs^Fms      , Gs^Fms      , Gs^Fms      , Rp^Vhcr     , Gg          , Rp          , Rp          , Rp          , Rp          , Chr         , Chr         , Hh          , Gs^Fms      , Gs^Fms      , Gs^Fds      , Gs^Fds      , Gs^Fms      , Gs^Fms      , Gs^Fms      , Gs^Fms      , Gs^Fms      
Hh          , Hh          , Gg          , Gg          , Gg          , Gg          , Gg          , Gs^Fms      , Gg          , Gg          , Gg          , Gg          , Rp          , Gg          , Gg          , Chr         , Khr         , Chr         , Gs^Fms      , Gs^Fms      , Gs^Fms      , Gs^Fms      , Gs^Fms      , Gs^Fms      , Gs^Fms      , Gs^Fms      , Gg          
Gg          , Gg          , Gg          , Gg          , Gg          , Gg          , Gg          , Gg          , Gg          , Gg          , Gg          , Gg          , Rp          , Gg          , Gg          , Chr         , Chr         , Chr         , Rp^Vhcr     , Gs^Fms      , Gs^Fms      , Gs^Fms      , Gs^Fms      , Gd^Vhr      , Gg          , Gs^Fms      , Hh^Fds      
Gg          , Gg          , Gg          , Gg          , Gg          , Gg          , Ww          , Gg          , Ww          , Ww          , Gg          , Gg          , Rp          , Gg          , Rp          , Rp          , Gg          , Gg          , Gg          , Gg          , Gg          , Gg          , Gg          , Gg          , Gs^Fds      , Gs^Fds      , Hh^Fds      
Gll^Fp      , Gg          , Gs^Fds      , Gg          , Gg          , Gg          , Gg          , Ww          , Ww          , Ww          , Gg          , Gg          , Rp          , Rp          , Gg          , Gg          , Gg          , Gg          , Gg          , Gg          , Gs^Fds      , Gg          , Gs^Fds      , Gs^Fds      , Hh          , Gs^Fds      , Hh          
Gll^Fp      , Gll^Fp      , Gll^Fp      , Gs^Fds      , Gs^Fds      , Gg          , Gg          , Ww          , Ww          , Ww          , Gg          , Gg          , Rp          , Rp          , Gg          , Gg          , Gg          , Gg          , Gg          , Gg          , Gs^Fds      , Gs^Fds      , Hh^Fds      , Hh^Fds      , Hh          , Hh          , Hh          
Gs^Fds      , Gs^Fds      , Gs^Fds      , Gs^Fds      , Gs^Fds      , Gg          , Gg          , Rp^Vhcr     , Gg          , Gg          , Gg          , Gg          , Rp          , Rp          , Rp          , Gg          , Gg          , Gg          , Gg          , Gs^Fds      , Gs^Fds      , Gs^Fds      , Hh^Fds      , Hh^Fds      , Hhd^Vhhr    , Hh          , Hh          
Gs^Fds      , Gs^Fds      , Gs^Fds      , Gll^Fp      , Gg          , Gg          , Gg          , Gg          , Gg          , Gg          , Gg          , Gg          , Rp          , Rp          , Gg          , Rp          , Gg          , Gg          , Gg          , Gg          , Gg          , Gs^Fds      , Gs^Fds      , Gs^Fds      , Gg          , Hh          , Hh          
Gll^Fp      , Gs^Fds      , Gll^Fp      , Rp^Vhcr     , Gg          , Gg          , Chr         , Gg          , Chr         , Gg          , Rp          , Rp          , Gg          , Gg          , Gg          , Rp          , Gg          , Gg          , Gg          , Gg          , Gg          , Gg          , Gg          , Gg          , Gg          , Gs^Fds      , Gs^Fds      
Gg          , Gll^Fp      , Gg          , Gg          , Gg          , Gg          , Gg          , Chr         , 1 Khr       , Chr         , Chr         , Gg          , Gg          , Gg          , Chr         , Rp          , Chr         , Chr         , Chr         , Gg          , Gg          , Gg          , Gg          , Gg          , Gs^Fds      , Gs^Fds      , Gs^Fds      
Gg          , Gg          , Gg          , Gg          , Gg          , Gg          , Gg          , Chr         , Chr         , Chr         , Rp^Vhcr     , Gg          , Gg          , Gg          , Gs^Fds      , Chr         , Chr         , 2 Khr       , Chr         , Gg          , Gs^Fds      , Gg          , Gs^Vl       , Gg          , Gs^Fds      , Gs^Fds      , Gs^Fds      
Gg          , Gg          , Gg          , Gg          , Gg          , Gg          , Gs^Fds      , Chr         , Gs^Fds      , Gs^Fds      , Gs^Fds      , Gg          , Gs^Fds      , Gs^Fds      , Gs^Fds      , Rp^Vhcr     , Gg          , Chr         , Gs^Fds      , Gs^Fds      , Gs^Fds      , Gs^Fds      , Gs^Fds      , Gs^Fds      , Gg          , Gs^Fds      , Gg          
Gg          , Gg          , Gg          , Gg          , Gs^Fds      , Gs^Fds      , Gs^Fds      , Gs^Fds      , Gs^Fds      , Gs^Fds      , Gs^Fds      , Gg          , Gs^Fds      , Gs^Fds      , Gs^Fds      , Gs^Fds      , Gs^Fds      , Gs^Fds      , Gs^Fds      , Gs^Fds      , Gs^Fds      , Gs^Fds      , Gs^Fds      , Gs^Fds      , Gs^Fds      , Gs^Fds      , Gs^Fds      
Gg          , Gg          , Gg          , Gs^Fds      , Gs^Fds      , Gs^Fds      , Gs^Fds      , Gs^Fds      , Gs^Fds      , Gs^Fds      , Gs^Fds      , Gs^Fds      , Gs^Fds      , Gs^Fds      , Gs^Fds      , Gs^Fds      , Gs^Fds      , Gs^Fds      , Gs^Fds      , Gs^Fds      , Gg          , Gs^Fds      , Gs^Fds      , Gs^Fds      , Gs^Fds      , Gs^Fds      , Gs^Fds      
