border_size=1
usage=map

_off^_usr   , _off^_usr   , _off^_usr   , _off^_usr   , _off^_usr   , _off^_usr   , _off^_usr   , _off^_usr   , _off^_usr   , _off^_usr   , _off^_usr   , _off^_usr   , Ha          , Ha          , Aa          , Aa          , Aa          , Aa          , Aa          , Aa          , Aa          , Aa          , Gd          , Gd          , Gd          , Gd          , Gd          , _off^_usr   , _off^_usr   , _off^_usr   , _off^_usr   , _off^_usr   , _off^_usr   
_off^_usr   , _off^_usr   , _off^_usr   , _off^_usr   , _off^_usr   , _off^_usr   , _off^_usr   , _off^_usr   , _off^_usr   , _off^_usr   , Rrc         , Ha          , Ha          , Aa          , Aa          , Aa          , Gg          , Aa          , Gg          , Gg          , Gg          , Gd          , Gd          , Gd          , Gd          , Gd          , Gs^Vh       , Gd          , Gd          , _off^_usr   , _off^_usr   , _off^_usr   , _off^_usr   
_off^_usr   , _off^_usr   , _off^_usr   , _off^_usr   , _off^_usr   , _off^_usr   , _off^_usr   , _off^_usr   , Ha          , Rrc         , Rrc         , Rrc         , Rrc         , Aa          , Gg          , Gg          , Gg          , Gg          , Gg          , Gg          , Gg          , Gg          , Gg          , Gs^Vh       , Gd          , Gd          , Gd          , Gd          , Gd          , Gd          , Gd          , _off^_usr   , _off^_usr   
_off^_usr   , _off^_usr   , _off^_usr   , _off^_usr   , _off^_usr   , _off^_usr   , Ha          , Ha          , Aa          , Ha          , Aa          , Rrc         , Rrc         , Rrc         , Rrc         , Gg          , Gg          , Gg          , Gg          , Gg          , Gg          , Gg          , Gd          , Gd          , Ce          , Ce          , Ce          , Hhd         , Hhd         , Gd          , Gd          , Gd          , Gd          
_off^_usr   , _off^_usr   , _off^_usr   , _off^_usr   , Ha          , Ha          , Ha          , Ha          , Aa          , Aa          , Gs          , Aa          , Gs          , Rrc         , Rrc         , Rrc         , Rrc         , Gg          , Gg          , Gg          , Gg          , Gg          , Gd          , Ce          , 4 Ke        , Ce          , Hhd         , Hhd         , Hhd         , Gs^Vh       , Gd          , Gd          , Gd          
_off^_usr   , _off^_usr   , Aa          , Aa          , Aa          , Ha          , Aa          , Gg          , Gg          , Aa          , Gs          , Gs          , Gs          , Gs          , Gs          , Rrc         , Rrc         , Rrc         , Rrc         , Gg          , Gg          , Gg          , Gg          , Gg          , Ce          , Ce          , Hhd         , Hhd         , Gd          , Gd          , Gd          , Gd          , Gd          
Aa          , Aa          , Gg          , Aa          , Aa          , Aa          , Cea         , Ce          , Gg          , Gs          , Gs^Vh       , Gs          , Gd^Fmw      , Gd^Fmw      , Hhd^Fmw     , Gs          , Gs          , Rrc         , Rrc         , Rrc         , Rrc         , Gg          , Gg          , Gg          , Gd          , Hhd         , Hhd         , Gs^Vh       , Gd          , Gd          , Hhd         , Hhd         , Hhd         
Aa          , Aa          , Gg          , Gg          , Gg          , Ce          , 5 Ke        , Ce          , Ce          , Gg          , Gg          , Gs          , Gs          , Gd^Fmw      , Hhd^Fmw     , Hhd         , Gs          , Gs          , Gs          , Rrc         , Rrc         , Rrc         , Rrc         , Gg          , Gg          , Gd          , Hhd         , Gd          , Gd          , Gd          , Gd          , Hhd         , Hhd         
Aa          , Aa          , Gg          , Gg          , Gg          , Ce          , Ce          , Ce          , Gg          , Gg          , Gg          , Gg          , Gs          , Gs          , Gs          , Gs          , Gs          , Gs          , Gs^Vl       , Gg          , Gg          , Rrc         , Rrc         , Rrc         , Gg          , Gd          , Hh          , Hhd         , Hhd         , Hhd         , Hhd         , Hhd         , Hhd         
Aa          , Aa          , Gg          , Gg          , Gs          , Gg          , Gs          , Gg          , Gg          , Gg          , Gg          , Gs^Vh       , Gd^Fmw      , Gs          , Gg          , Gg          , Hh          , Hh          , Hh          , Gg          , Gg          , Rrc         , Rrc         , Rrc         , Gg          , Hh          , Hh          , Hh          , Hh          , Hhd         , Mm          , Hhd         , Mm          
Gg          , Gg          , Gg          , Gs^Vh       , Gs          , Gs          , Gs^Vh       , Gs          , Gs          , Gs          , Gg          , Gd^Fmw      , Hhd         , Hh          , Hh          , Hh          , Mm          , Mm          , Hh          , Gg          , Gg          , Rrc         , Rrc         , Rrc         , Hh          , Gs^Vl       , Hh          , Hh          , Mm          , Mm          , Mm          , Mm          , Mm          
Gg          , Gg          , Gg          , Gg          , Gs          , Gs          , Gs          , Gs          , Gs^Vl       , Re          , Re          , Gd^Fmw      , Hhd         , Hhd         , Mm          , Mm          , Mm          , Mm          , Mm          , Hh          , Hh          , Rrc         , Rrc         , Rrc         , Hh          , Hh          , Mm          , Mm          , Mm          , Mm          , Mm          , Mm          , Mm          
Gg          , Gg          , Gg          , Gg          , Gs          , Gs          , Gd^Fmw      , Gd^Fmw      , Gd^Fmw      , Gd^Fmw      , Re          , Hhd         , Hhd         , Hhd         , Mm          , Mm          , Mm          , Mm          , Mm          , Hh          , Ch          , Ch          , Ch          , Ch          , Ch          , Mm          , Mm          , Mm          , Mm          , Mm          , Mm          , Mm          , Mm          
Gg          , Gg          , Gg          , Gg          , Hhd         , Gd^Fmw      , Hhd         , Hhd^Fmw     , Hhd^Fmw     , Hhd^Fmw     , Re          , Gs^Vl       , Mm          , Mm          , Mm          , Mm          , Mm          , Mm          , Mm          , Ch          , Rr^Vhc      , Rr^Vhc      , 3 Kh        , Rr^Vhc      , Rr^Vhc      , Ch          , Mm          , Mm          , Mm          , Mm          , Mm          , Mm          , Mm          
Hhd         , Gg          , Gg          , Gg          , Hhd         , Hhd         , Hhd         , Hhd^Fmw     , Hhd^Fmw     , Hhd^Fmw     , Md          , Re          , Mm          , Mm          , Mm          , Mm          , Mm          , Mm          , Mm          , Ch          , Ch          , Rr^Vhc      , Ch          , Rr^Vhc      , Ch          , Ch          , Mm          , Mm          , Mm          , Mm          , Mm          , Mm          , Mm          
Hhd         , Hhd         , Hhd         , Hhd         , Hhd         , Hhd         , Md          , Hhd         , Md          , Md          , Md          , Re          , Mm          , Mm          , Mm          , Mm          , Mm          , Mm          , Mm          , Mm          , Hh          , Ch          , Rrc         , Ch          , Hh          , Hh          , Hh          , Mm          , Mm          , Mm          , Mm          , Mm          , Mm          
Mm          , Hhd         , Md          , Md          , Md          , Md          , Md          , Md          , Md          , Md          , Md          , Re          , Re          , Mm          , Mm          , Mm          , Mm          , Mm          , Mm          , Mm          , Hh          , Rrc         , Rrc         , Rrc         , Gg          , Hh          , Gg          , Hh          , Hh          , Hh          , Hh          , Mm          , Hh          
Mm          , Mm          , Mm          , Md          , Md          , Md          , Md          , Md          , Mm          , Md          , Mm          , Mm          , Mm          , Re          , Re          , Mm          , Mm          , Mm          , Mm          , Hh          , Gg          , Rrc         , Rrc         , Rrc         , Ce          , Ce          , Ce          , Gs^Vl       , Gg          , Hh          , Hh          , Hh          , Hh          
Mm          , Mm          , Mm          , Mm          , Mm          , Md          , Mm          , Mm          , Mm          , Mm          , Mm          , Mm          , Mm          , Mm          , Re          , Mm          , Mm          , Mm          , Hh          , Hh          , Gg          , Rrc         , Ce          , Ce          , Ce          , 2 Ke        , Ce          , Ce          , Gg          , Gg          , Hh          , Hh          , Gg          
Mm          , Mm          , Mm          , Mm          , Mm          , Mm          , Mm          , Mm          , Mm          , Mm          , Mm          , Mm          , Mm          , Mm          , Mm          , Re          , Re          , Hh          , Hh          , Gg          , Ce          , Rrc         , Rrc         , Ce          , Gg          , Ce          , Gg          , Gg          , Gg          , Gg          , Hh          , Hh          , Gg          
Mm          , Mm          , Mm          , Mm          , Mm          , Mm          , Mm          , Mm          , Mm          , Mm          , Mm          , Mm          , Mm          , Mm          , Hh          , Hh          , Hh          , Re          , Gg          , Gg          , Ce          , Ce          , Ce          , Rrc         , Gg          , Gg          , Gg          , Gg          , Gg          , Gs^Vh       , Gg          , Gg          , Gg          
_off^_usr   , Mm          , Mm          , Mm          , Mm          , Mm          , Mm          , Mm          , Mm          , Mm          , Mm          , Mm          , Mm          , Hh          , Hh          , Hh          , Hh          , Re          , Gg          , Gg          , Ce          , 1 Ke        , Ce          , Rrc         , Gg          , Gg          , Gg          , Gg          , Gs^Fds      , Gg          , Gs^Fds      , Gs^Fds      , Gs^Fds      
_off^_usr   , _off^_usr   , _off^_usr   , Mm          , Mm          , Mm          , Mm          , Mm          , Mm          , Mm          , Mm          , Mm          , Hh          , Hh          , Hhd^Fmw     , Gd^Fmw      , Gs^Vl       , Re          , Gg          , Gg          , Ce          , Ce          , Rrc         , Rrc         , Gg          , Gg          , Gs^Fds      , Gs^Fds      , Gs^Fds      , Gs^Fds      , Gs^Fds      , Gs^Fds      , _off^_usr   
_off^_usr   , _off^_usr   , _off^_usr   , _off^_usr   , _off^_usr   , Mm          , Mm          , Mm          , Mm          , Mm          , Mm          , Mm          , Hhd         , Hhd^Fmw     , Gd^Fmw      , Gd^Fmw      , Re          , Re          , Gg          , Ce          , Gg          , Rrc         , Rrc         , Rrc         , Gg          , Gg          , Gg          , Gs^Fds      , Gs^Fds      , Gs^Fds      , _off^_usr   , _off^_usr   , _off^_usr   
_off^_usr   , _off^_usr   , _off^_usr   , _off^_usr   , _off^_usr   , _off^_usr   , _off^_usr   , Mm          , Mm          , Mm          , Mm          , Hh          , Hh          , Hhd^Fmw     , Gd^Fmw      , Gd^Fmw      , Re          , Gg          , Gg          , Gg          , Rr^Vhc      , Rrc         , Rrc         , Rrc         , Rr^Vhc      , Gg          , Gs^Fds      , Gs^Fds      , _off^_usr   , _off^_usr   , _off^_usr   , _off^_usr   , _off^_usr   
_off^_usr   , _off^_usr   , _off^_usr   , _off^_usr   , _off^_usr   , _off^_usr   , _off^_usr   , _off^_usr   , _off^_usr   , Mm          , Mm          , Hh          , Hh          , Gd^Fmw      , Gg          , Gs^Vl       , Gg          , Gg          , Gg          , Gg          , Gg          , Rrc         , Rrc         , Rrc         , Gg          , Gg          , _off^_usr   , _off^_usr   , _off^_usr   , _off^_usr   , _off^_usr   , _off^_usr   , _off^_usr   
_off^_usr   , _off^_usr   , _off^_usr   , _off^_usr   , _off^_usr   , _off^_usr   , _off^_usr   , _off^_usr   , _off^_usr   , _off^_usr   , _off^_usr   , Hh          , Hh          , Gg          , Gg          , Gg          , Gg          , Gg          , Gg          , Gg          , Gg          , Rrc         , Rrc         , Rrc         , _off^_usr   , _off^_usr   , _off^_usr   , _off^_usr   , _off^_usr   , _off^_usr   , _off^_usr   , _off^_usr   , _off^_usr   
_off^_usr   , _off^_usr   , _off^_usr   , _off^_usr   , _off^_usr   , _off^_usr   , _off^_usr   , _off^_usr   , _off^_usr   , _off^_usr   , _off^_usr   , _off^_usr   , _off^_usr   , Gg          , Gs^Fds      , Gg          , Gs^Fds      , Gs^Fds      , Gg          , Gg          , Gg          , Rrc         , _off^_usr   , _off^_usr   , _off^_usr   , _off^_usr   , _off^_usr   , _off^_usr   , _off^_usr   , _off^_usr   , _off^_usr   , _off^_usr   , _off^_usr   
_off^_usr   , _off^_usr   , _off^_usr   , _off^_usr   , _off^_usr   , _off^_usr   , _off^_usr   , _off^_usr   , _off^_usr   , _off^_usr   , _off^_usr   , _off^_usr   , _off^_usr   , _off^_usr   , _off^_usr   , Gs^Fds      , Gs^Fds      , Gs^Fds      , Gs^Fds      , Gs^Fds      , _off^_usr   , _off^_usr   , _off^_usr   , _off^_usr   , _off^_usr   , _off^_usr   , _off^_usr   , _off^_usr   , _off^_usr   , _off^_usr   , _off^_usr   , _off^_usr   , _off^_usr   
