border_size=1
usage=map

Ms^Xm       , Ms^Xm       , Ms^Xm       , Ms^Xm       , Ms^Xm       , Ms^Xm       , Ms^Xm       , Ms^Xm       , Ms          , Ms          , Ms          , Ms          , Ms          , Ms          , Ha          , Ha          , Ha          , Ha          , Ha          , Ha          , Ms          , Ms^Xm       , Ms^Xm       , Ms^Xm       , Wwg         , Wwg         , Wwg         , Wwg         , Ms^Xm       
Ms^Xm       , Ms^Xm       , Ms^Xm       , Ms^Xm       , Ms^Xm       , Ms^Xm       , Ms          , Ms          , Ms          , Ha          , Ha          , Ha          , Rrc^Vhca    , Ha          , Ha          , Ha          , Rrc^Vhca    , Ha          , Ms          , Ms          , Ms          , Ms^Xm       , Ms^Xm       , Ms^Xm       , Wwg         , Wwg         , Ms^Xm       , Ms^Xm       , Ms^Xm       
Ms^Xm       , Ms^Xm       , Ms^Xm       , Ms^Xm       , Ms          , Ms          , Ms          , Ms          , Ha          , Ha          , Rrc^Vhca    , Rrc^Vhca    , Cha         , Cha         , Cha         , Cha         , Cha         , Rrc^Vhca    , Rrc^Vhca    , Ms          , Ms          , Ms          , Ms          , Wwg         , Wwg         , Wwg         , Ms^Xm       , Ms^Xm       , Ms^Xm       
Ms^Xm       , Ms^Xm       , Ms^Xm       , Ms^Xm       , Ms          , Ms          , Ms          , Ms          , Ha          , Ha          , Cha         , Rrc^Vhca    , Cha         , Rrc^Vhca    , Cha         , Rrc^Vhca    , Cha         , Rrc^Vhca    , Cha         , Ms          , Ms          , Ms          , Ms          , Wwg         , Wwg         , Wwg         , Ms^Xm       , Ms^Xm       , Ms^Xm       
Ms^Xm       , Ms^Xm       , Ms^Xm       , Ms          , Ms          , Ms          , Ms          , Ms          , Ms          , Ha          , Cha         , Cha         , Cha         , Cha         , 6 Kha       , Cha         , Cha         , Cha         , Cha         , Ms          , Ms          , Ms          , Ms          , Wwg         , Wwg         , Wwg         , Ms          , Ms^Xm       , Ms^Xm       
Ms^Xm       , Ms^Xm       , Ms          , Ms          , Ms          , Ms          , Ms          , Ms          , Ms          , Ms          , Ms          , Cha         , Cha         , Cha         , Cha         , Cha         , Cha         , Cha         , Aa          , Ms          , Ms          , Ms          , Ms          , Wwg         , Wwg         , Ms          , Ms          , Ms          , Ms          
Ms          , Ms          , Ms          , Ms          , Ms          , Ms          , Ms          , Ms          , Ms          , Ms          , Ms          , Cha         , Cha         , Rrc^Vhca    , Rrc^Vhca    , Rrc^Vhca    , Cha         , Cha         , Aa          , Aa          , Aa          , Ms          , Ms          , Wwg         , Wwg         , Ms          , Ms          , Ms          , Ms          
Ms          , Ms          , Ms          , Ms          , Ms          , Ms          , Ms          , Ms          , Aa          , Ms          , Aa          , Cha         , Cha         , Cha         , Rrc         , Cha         , Cha         , Cha         , Aa          , Aa^Fpa      , Aa^Fpa      , Aa          , Ms          , Wwg         , Wwg         , Ms          , Ms          , Ms          , Ms          
Ms          , Ms          , Ms          , Ms          , Ms          , Ms          , Ms          , Aa          , Aa          , Aa          , Aa          , Aa          , Aa          , Aa          , Rrc         , Aa          , Aa          , Aa          , Aa          , Aa^Fpa      , Aa          , Aa          , Wwg         , Wwg         , Wwg         , Ms          , Ms          , Ms          , Ms          
Ms          , Ms          , Ms          , Ms          , Ms          , Ms          , Ha          , Ha          , Aa          , Aa          , Aa          , Aa          , Aa          , Aa          , Rrc         , Rrc         , Rrc         , Rrc         , Rrc         , Aa          , Aa          , Wwg         , Wwg         , Wwg         , Aa          , Ms          , Aa          , Ms          , Ms          
Ms          , Ms          , Ha^Fda      , Ms          , Ha^Fpa      , Ha          , Ha          , Aa          , Aa          , Aa          , Aa          , Aa          , Aa          , Aa          , Rrc         , Aa          , Aa          , Aa          , Wwg         , Rrc         , Wwg^Bsb\    , Wwg         , Wwg         , Aa          , Aa          , Aa          , Rrc^Vhca    , Aa          , Ms          
Ha          , Ha          , Ha          , Ha^Fpa      , Ha^Fpa      , Ha          , Aa^Fda      , Aa          , Aa          , Aa          , Aa^Fpa      , Aa          , Aa          , Aa          , Rrc         , Aa          , Wwg         , Wwg         , Wwg         , Wwg         , Wwg         , Wwg^Bsb\    , Rrc         , Aa          , Rrc         , Rrc         , Aa          , Aa          , Ms          
Ha          , Ha          , Aa          , Ha^Fda      , Aa^Fma      , Aa^Fda      , Aa^Fda      , Aa          , Aa          , Aa          , Aa          , Aa          , Wwg         , Wwg         , Wwg         , Rrc         , Wwg^Bsb\    , Wwg         , Aa          , Wwg         , Aa          , Aa          , Aa          , Rrc         , Aa          , Aa          , Ha          , Ms          , Ms          
Aa          , Aa          , Aa          , Aa^Fma      , Aa          , Aa^Vca      , Aa          , Aa          , Aa          , Aa          , Wwg         , Wwg         , Wwg         , Wwg         , Wwg         , Wwg         , Wwg         , Wwg^Bsb\    , Rrc         , Aa          , Aa          , Ha          , Ha          , Ha          , Ha^Fpa      , Ha          , Ms          , Ms          , Ms          
Aa^Fpa      , Aa          , Aa          , Aa          , Aa          , Aa          , Aa          , Aa          , Ai          , Wwg         , Ai          , Wwg         , Aa          , Aa          , Aa          , Wwg         , Aa          , Aa          , Aa          , Rrc         , Aa          , Aa          , Ha          , Ha^Fpa      , Ha^Fpa      , Ms          , Ms          , Ms          , Ms          
Aa^Fpa      , Aa^Fpa      , Aa^Fpa      , Aa          , Aa          , Aa          , Aa          , Ai          , Ai          , Ai          , Aa          , Aa          , Aa          , Aa          , Ha          , Aa          , Aa          , Aa          , Aa          , Rrc         , Rrc^Vhca    , Aa          , Aa          , Ha          , Ms          , Ms          , Ms          , Ms          , Ms          
Aa^Fpa      , Aa^Fpa      , Aa          , Aa          , Aa          , Aa          , Ai          , Ai          , Ai          , Aa          , Aa          , Aa          , Aa          , Ha          , Ha          , Aa          , Aa          , Aa          , Aa          , Aa          , Aa          , Aa          , Aa          , Ha          , Ha^Fpa      , Ms          , Ms          , Ms          , Ms          
Aa^Fpa      , Aa^Fpa      , Aa^Fpa      , Aa          , Aa          , Aa          , Ai          , Ai          , Aa          , Aa          , Aa          , Aa          , Aa^Fma      , Ha^Fma      , Ha^Fma      , Ha          , Aa          , Aa          , Aa          , Aa          , Aa^Fpa      , Aa          , Aa          , Aa          , Ha          , Ha^Fpa      , Ms          , Ms          , Ms          
Aa^Fpa      , Aa^Fpa      , Aa          , Aa          , Wwg         , Ai          , Ai          , Ai          , Aa          , Aa          , Aa          , Aa          , Aa^Fpa      , Aa^Fma      , Ha^Fma      , Aa^Fpa      , Aa          , Aa          , Aa          , Aa^Fpa      , Aa          , Aa          , Aa          , Aa          , Aa          , Ha          , Ha^Fda      , Ms          , Ms          
Aa^Fpa      , Aa^Fpa      , Aa          , Ai          , Wwg         , Wwg         , Aa          , Aa          , Aa          , Aa          , Aa          , Aa^Fpa      , Aa^Fpa      , Aa^Fma      , Aa^Fpa      , Aa^Fpa      , Aa          , Aa          , Aa          , Aa          , Aa          , Aa          , Aa          , Aa          , Aa          , Aa          , Aa          , Ha          , Ha          
Aa^Fpa      , Aa^Fpa      , Aa          , Ai          , Wwg         , Aa          , Aa          , Aa          , Aa          , Aa          , Aa          , Aa^Fpa      , Aa          , Aa          , Aa          , Aa          , Aa          , Aa          , Aa          , Aa          , Cea         , Aa          , Rb          , Rb          , Rb          , Aa^Vca      , Aa          , Ha          , Ha          
Aa          , Aa          , Aa          , Wwg         , Wwg         , Aa          , Aa          , Aa          , Aa          , Aa          , Aa          , Aa          , Aa          , Aa          , Aa          , Aa          , Aa          , Aa          , Aa          , Cea         , 5 Kea       , Cea         , Aa          , Aa          , Aa          , Aa          , Aa          , Aa          , Aa          
Aa          , Aa          , Aa          , Wwg         , Wwg         , Wwg         , Wwg         , Aa          , Aa          , Aa          , Aa          , Aa          , Aa^Vha      , Aa          , Re          , Aa          , Re          , Re          , Re          , Cea         , Cea         , Cea         , Aa          , Aa          , Aa          , Aa          , Aa          , Aa          , Ha          
Aa          , Aa          , Aa          , Aa          , Aa          , Wwg         , Wwg         , Wwg         , Aa          , Aa          , Re          , Re          , Re          , Re          , Aa          , Re          , Aa          , Aa          , Re          , Aa          , Aa          , Aa          , Aa          , Aa          , Ha          , Ha          , Ha          , Ha          , Ha          
Aa          , Aa          , Aa          , Aa          , Aa          , Aa          , Wwg         , Wwg         , Wwg^Bw/     , Re          , Aa          , Aa          , Aa          , Aa          , Aa          , Aa          , Aa          , Aa          , Re          , Aa          , Aa          , Aa          , Aa          , Aa          , Ha          , Ha          , Ms          , Ms          , Ms          
Aa          , Aa          , Aa          , Aa          , Aa          , Aa          , Re          , Wwg^Bw/     , Wwg         , Wwg         , Wwg         , Aa          , Wwg         , Wwg         , Wwg         , Aa          , Re          , Re          , Aa^Vla      , Re          , Rd          , Aa          , Aa          , Aa          , Ha          , Ms          , Ms          , Ms          , Ms          
Aa          , Aa          , Aa^Fpa      , Aa^Fpa      , Aa          , Aa          , Cea         , Cea         , Cea         , Wwg         , Wwg         , Wwg         , Wwg         , Wwg         , Wwg^Bw/r    , Wwg^Bw/r    , Wwg         , Aa^Fma      , Aa^Fpa      , Aa^Fda      , Aa          , Rd          , Aa          , Aa          , Aa          , Ha          , Ms          , Ms          , Ms          
Aa          , Aa          , Aa          , Aa          , Aa          , Aa          , Cea         , 4 Kea       , Cea         , Aa^Fpa      , Aa^Vla      , Wwg         , Re          , Re          , Wwg         , Wwg         , Wwg         , Aa^Fpa      , Aa^Fpa      , Aa^Fma      , Aa          , Rd          , Rd          , Aa          , Aa          , Ha          , Ha          , Ms          , Ms          
Aa          , Aa          , Aa          , Aa          , Aa          , Aa          , Aa          , Cea         , Aa          , Re          , Re          , Re          , Aa          , Aa          , Aa          , Wwg         , Wwg         , Wwg         , Wwg         , Aa          , Aa          , Aa          , Rd          , Aa          , Aa          , Aa          , Ha          , Ha          , Ha          
Aa          , Aa          , Aa          , Aa          , Aa          , Aa          , Aa          , Aa          , Aa          , Aa          , Aa          , Aa          , Aa          , Aa          , Aa          , Aa          , Wwg         , Wwg         , Wwg         , Aa          , Aa          , Aa          , Rd          , Aa          , Aa          , Aa          , Aa          , Ha          , Ha          
Aa          , Aa          , Ha          , Ha          , Ha          , Ha          , Aa^Fma      , Aa          , Aa^Fpa      , Aa^Fpa      , Aa          , Aa          , Aa          , Aa          , Aa          , Aa          , Aa          , Wwg         , Wwg         , Aa          , Aa          , Aa          , Aa          , Aa^Vha      , Aa          , Aa          , Aa          , Aa          , Aa          
Aa          , Aa          , Aa          , Ha          , Ha^Fpa      , Ha^Fpa      , Aa^Fma      , Aa^Fma      , Aa^Fpa      , Aa^Fma      , Aa^Vha      , Aa          , Aa          , Aa          , Aa          , Aa          , Aa          , Wwg         , Wwg         , Wwg         , Wwg         , Aa          , Aa          , Aa          , Aa          , Aa          , Aa          , Aa          , Aa          
Aa          , Aa          , Aa^Fma      , Aa^Fda      , Aa^Fda      , Ha^Fpa      , Aa^Fma      , Aa^Fma      , Aa^Fma      , Rd          , Aa          , Aa          , Aa          , Aa          , Aa          , Aa          , Aa          , Aa          , Wwg         , Wwg         , Wog         , Wwg         , Wwg         , Ai          , Ai          , Ai          , Ai          , Ai          , Ai          
Aa          , Aa          , Aa^Fda      , Aa^Fda      , Aa^Fma      , Aa^Fpa      , Aa^Fma      , Aa^Fda      , Aa^Fma      , Rd          , Aa          , Aa          , Aa          , Aa          , Aa          , Aa^Fpa      , Aa^Fpa      , Aa          , Aa          , Wwg         , Wog         , Wog         , Wog         , Wwg         , Ai          , Ai          , Ai          , Ai          , Ai          
Aa          , Aa          , Aa^Fda      , Aa^Fda      , Aa^Fpa      , Aa^Fpa      , Aa^Fda      , Aa^Fma      , Aa^Fma      , Rd          , Aa          , Aa          , Aa          , Aa          , Aa          , Aa^Fpa      , Aa          , Aa          , Aa          , Wwg         , Ai          , Wog         , Ai          , Wog         , Ai          , Ai          , Ai          , Ai          , Ai          
Aa          , Aa          , Aa          , Aa^Fpa      , Aa^Fma      , Aa^Fpa      , Rd          , Rd          , Rd          , Rd          , Aa          , Aa          , Aa          , Aa          , Aa          , Aa          , Aa          , Aa          , Aa          , Ai          , Ai          , Ai          , Ai          , Ai          , Ai          , Ai          , Ai          , Ai          , Ai          
Aa          , Aa          , Aa          , Aa^Fpa      , Aa          , Aa^Vha      , Rd          , Aa          , Aa          , Rd          , Rd          , Aa          , Aa          , Aa          , Aa          , Aa          , Aa          , Aa          , Aa          , Aa          , Ai          , Ai          , Ai          , Ai          , Ai          , Ai          , Ai          , Ai          , Ai          
Aa          , Aa          , Aa          , Aa          , Aa          , Aa          , Rd          , Aa          , Aa          , Aa          , Aa          , Rd          , Aa^Vha      , Aa          , Aa          , Aa          , Aa          , Aa          , Aa          , Aa          , Aa^Vca      , Ai          , Ai          , Ai          , Ai          , Ai          , Ai          , Ai          , Ai          
Aa          , Aa          , Aa          , Aa          , Aa          , Rd          , Aa          , Aa          , Aa          , Aa          , Aa          , Aa          , Aa          , Aa          , Aa          , Aa          , Aa          , Aa          , Rd          , Rd          , Aa          , Ai          , Ai          , Ai          , Ai          , Ai          , Ai          , Ai          , Ai          
Aa          , Aa          , Aa          , Aa          , Rd          , Rd          , Aa          , Aa          , Aa          , Aa^Fpa      , Aa          , Aa          , Aa          , Aa          , Aa          , Aa          , Aa          , Rd          , Aa          , Rd          , Aa          , Aa          , Aa          , Ai          , Ai          , Ai          , Ai          , Ai          , Ai          
Aa          , Aa          , Aa          , Aa          , Rd          , Aa          , Aa          , Aa          , Aa          , Aa          , Aa          , Aa          , Aa          , Aa          , Rrc^Vhca    , Aa          , Rd          , Rd          , Aa          , Rd          , Rd          , Aa          , Aa          , Aa          , Aa          , Aa^Vca      , Aa          , Ai          , Ai          
Aa          , Aa          , Aa          , Aa          , Aa          , Rd          , Aa          , Aa          , Aa          , Aa          , Aa          , Aa          , Aa          , Rrc^Vhca    , Cha         , Rrc^Vhca    , Aa          , Aa          , Aa          , Aa          , Aa          , Rd          , Aa          , Aa          , Aa          , Rd          , Aa          , Aa          , Aa          
Aa          , Aa          , Aa          , Aa          , Aa          , Rd          , Aa          , Aa          , Aa          , Aa          , Aa          , Aa          , Cha         , Cha         , Cha         , Cha         , Cha         , Aa          , Aa          , Aa          , Aa          , Rd          , Rd          , Aa          , Rd          , Rd          , Aa          , Aa          , Aa          
Aa          , Aa          , Aa          , Aa          , Cea         , Cea         , Cea         , Aa          , Aa          , Aa          , Aa          , Aa          , Cha         , Cha         , 3 Kha       , Cha         , Cha         , Aa          , Aa          , Aa          , Aa          , Aa          , Cea         , Cea         , Cea         , Aa          , Aa          , Aa          , Aa^Fpa      
Aa          , Aa          , Aa          , Cea         , Cea         , 1 Kea       , Aa^Vha      , Aa          , Aa^Fpa      , Aa^Fpa      , Aa^Fpa      , Aa          , Aa          , Cha         , Cha         , Cha         , Aa          , Aa          , Aa          , Aa          , Aa          , Aa          , Aa^Vha      , 2 Kea       , Cea         , Cea         , Aa          , Aa          , Aa^Fpa      
Aa          , Aa          , Aa          , Cea         , Aa^Vha      , Aa^Vha      , Aa          , Aa          , Aa^Fpa      , Aa^Fpa      , Aa          , Aa          , Aa          , Rrc         , Rrc         , Rrc         , Aa          , Aa          , Aa          , Aa          , Aa          , Aa          , Aa          , Aa^Vha      , Aa^Vha      , Cea         , Aa          , Aa^Fpa      , Aa^Fpa      
Aa          , Aa          , Aa          , Aa          , Aa          , Aa          , Aa          , Aa          , Aa          , Aa^Fpa      , Aa          , Aa          , Aa          , Rrc         , Rrc         , Rrc         , Aa          , Aa          , Aa^Fpa      , Aa^Fpa      , Aa^Fpa      , Aa^Fpa      , Aa^Fpa      , Aa          , Aa          , Aa          , Aa^Fpa      , Aa^Fpa      , Aa^Fpa      
Aa          , Aa          , Aa          , Aa          , Aa          , Aa          , Aa          , Aa          , Aa          , Aa          , Aa          , Aa          , Aa          , Rrc         , Rrc         , Rrc         , Aa          , Aa          , Aa^Fpa      , Aa^Fpa      , Aa^Fpa      , Aa^Fpa      , Aa^Fpa      , Aa^Fpa      , Aa^Fpa      , Aa^Fpa      , Aa^Fpa      , Aa^Fpa      , Aa^Fpa      
