border_size=1
usage=map

Gd          , Gd          , Gd          , Gd          , Gd          , Gd          , Gd          , Rd          , Gd          , Gd          , Gd          , Gd          , Gd          , Gd          , Gd          , Gd          , Gd          , Gd          , Gd          , Gd          , Gd          , Gd          , Gd          , Gd          , Gd          , Rd          , Rd          , Rd          , Sm          , Sm          , Sm          , Sm          , Sm          , Sm          , Sm          , Sm          , Sm          , Sm          , Sm          , Sm          
Gd          , Gd          , Gd          , Gd          , Gd^Vhr      , Gd          , Gd          , Gd          , Gd          , Gd          , Gd          , Gd          , Gd          , Gd          , Gd          , Gd          , Gd          , Gd          , Gd          , Gd          , Gd          , Gd          , Gd          , Gd          , Gd          , Rd          , Rd          , Rd          , Sm          , Sm          , Sm          , Sm          , Sm          , Sm          , Sm          , Sm          , Sm          , Sm          , Sm          , Sm          
Gd          , Gd          , Gd          , Gd          , Gd          , Gd          , Gd          , Gd          , Gd          , Gd          , Gd          , Gd          , Gd^Vhr      , Gd          , Gd          , Gd^Fetd     , Gd          , Gd          , Gd          , Gd          , Gd          , Gd^Vhr      , Gd          , Gd          , Rd          , Rd          , Rd          , Rd          , Sm          , Sm          , Sm          , Sm          , Sm          , Sm          , Sm          , Sm          , Sm          , Sm          , Sm          , Sm          
Gd          , Gd          , Gd          , Gd          , Gd          , Gd          , Gd          , Gd          , Gd          , Gd          , Gd          , Gd          , Gd          , Gd          , Gd          , Gd          , Gd          , Gd          , Gd          , Gd          , Gd          , Gd          , Rd          , Rd          , Rd          , Ce          , Ke          , Rd          , Rd          , Sm          , Sm          , Sm          , Sm          , Sm          , Sm          , Sm          , Sm          , Sm          , Sm          , Sm          
Gd          , Gd          , Gd          , Gd          , Ce          , 2 Ke        , Ce          , Gd          , Gd^Vhr      , Gd          , Gd          , Gd          , Gd          , Gd          , Rd          , Gd          , Rd          , Gd          , Rd          , Gd          , Rd          , Rd          , Rd          , Rd          , Rd          , Rd          , Rd          , Rd          , Sm          , Sm          , Sm          , Sm          , Sm          , Sm          , Sm          , Sm          , Sm          , Sm          , Rd          , Rd          
Gd          , Gd          , Gd          , Gd          , Gd          , Ce          , Gd          , Gd          , Gd          , Gd          , Gd          , Gd          , Gd          , Gd          , Gd          , Rd          , Rd          , Rd          , Ke          , Rd          , Rd          , Rd          , Rd          , Sm          , Sm          , Sm          , Sm          , Rd          , Sm          , Sm          , Sm          , Sm          , Rd          , Sm          , Rd          , Sm          , Rp^Vhcr     , Rp          , Rp          , Rd          
Gd          , Gd          , Gd          , Gd          , Gd          , Gd          , Gd          , Gd          , Gd          , Gd          , Gd          , Ke          , Ce          , Gd          , Gd^Vhr      , Rd          , Rd          , Rd          , Rd          , Ce          , Rd          , Rd          , Sm          , Sm          , Sm          , Sm          , Sm          , Sm          , Sm          , Sm          , Rd          , Rd          , Rd          , Rd          , Rd          , Rd          , Rd          , Rd          , Rd^Dr       , Rp          
Gd          , Gd          , Gd          , Gd          , Ce          , Gd          , Gd          , Gd          , Gd          , Gd          , Gd          , Ce          , Rd          , Gd          , Rd          , Rd          , Sm          , Rd          , Rd          , Rd          , Rd          , Rd          , Sm          , Sm          , Rd          , Sm          , Rd          , Rd          , Rd          , Rd          , Rd          , Rd          , Ce          , Ke          , Rd          , Rd          , Rd          , Rd          , Rd          , Rd          
Gd          , Gd          , Gd          , Ce          , 1 Ke        , Ce          , Gd          , Gd          , Rd          , Gd          , Gd          , Rd          , Gd          , Rd          , Rd          , Rd          , Sm          , Rd          , Sm          , Sm          , Sm          , Rd          , Sm          , Sm          , Rd          , Rd          , Ke          , Rd          , Rd          , Rd          , Rd          , Rd          , Rd          , Rd          , Rd          , Hhd         , Hhd         , Rd          , Rd          , Rd          
Gd          , Gd          , Gd          , Gd          , Gd          , Gd          , Gd          , Rd          , Rd          , Gd          , Gd          , Gd          , Gd^Vhr      , Rd          , Rd          , Rd          , Sm          , Sm          , Sm          , Sm          , Sm          , Sm          , Sm          , Sm          , Rd          , Rd          , Rd          , Ce          , Rd          , Rd          , Rd          , Rd          , Rd          , Rd          , Hhd         , Hhd         , Hhd         , Rd          , Rd          , Rd          
Gd          , Gd          , Gd          , Rd          , Gd          , Gd^Vhr      , Gd          , Rd          , Gd          , Ce          , Ce          , Gd          , Rd          , Rd          , Sm          , Sm          , Sm          , Sm          , Rd          , Sm          , Rd          , Sm          , Sm          , Sm          , Rd          , Rd          , Rd          , Rd          , Rd          , Rd          , Rd          , Rd          , Rd          , Hhd         , Hhd         , Hhd^Vhhr    , Rd          , Rd          , Rd          , Rd          
Rd          , Gd^Vhr      , Rd          , Rd          , Rd          , Gd          , Rd          , Rd          , Rd          , Ke          , Rd          , Gd          , Rd          , Sm          , Sm          , Sm          , Sm          , Sm          , Rd          , Rd          , Rd          , Rd          , Rd          , Rd          , Rd          , Rd          , Hhd         , Hhd^Vhhr    , Hhd         , Hhd         , Rd          , Rd          , Rd          , Rd          , Rd          , Hhd         , Rd          , Rd          , Rd          , Rd          
Rd          , Rd          , Rd          , Rd          , Rd          , Rd          , Rd          , Rd          , Sm          , Rd          , Sm          , Sm          , Sm          , Sm          , Sm          , Sm          , Sm          , Sm          , Rd          , Ce          , Rd          , Rd          , Rd^Dr       , Rd          , Rd          , Hhd         , Hhd         , Hhd         , Rd          , Hhd         , Rd          , Rd          , Rd          , Rd          , Rd          , Rd          , Rd          , Rd          , Dd          , Dd          
Rd          , Rd          , Rd          , Rd          , Sm          , Rd          , Rd          , Rd          , Sm          , Sm          , Sm          , Sm          , Sm          , Sm          , Sm          , Sm          , Sm          , Rd          , Rd          , Ke          , Rd          , Rd          , Rd          , Rd          , Rd          , Rd          , Rd          , Rd          , Rd          , Rd          , Rd          , Rd          , Rd          , Rd          , Rd          , Rd          , Rd          , Rd          , Dd          , Dd          
Rd          , Rd          , Rd          , Rd          , Sm          , Sm          , Sm          , Sm          , Sm          , Sm          , Sm          , Rd          , Rd          , Rd          , Rd          , Sm          , Rd          , Rd          , Rd          , Rd          , Rd          , Rd          , Rd          , Rd          , Rd          , Rd          , Ce          , Rd          , Rd          , Rd          , Rd          , Rd          , Rd          , Rd          , Ce          , Rd          , Dd          , Dd          , Dd^Esd      , Dd          
Sm          , Sm          , Sm          , Sm          , Sm          , Sm          , Sm          , Sm          , Sm          , Sm          , Rd          , Rd          , Ke          , Rd          , Rd          , Rd          , Rd          , Rd          , Dd^Vdt      , Rd          , Rd          , Rd          , Rd          , Rd          , Rd          , Rd          , Ke          , Rd          , Rd          , Rd          , Rd          , Rd          , Rd          , Ce          , 3 Ke        , Ce          , Dd          , Dd          , Dd^Vdt      , Dd          
Sm          , Sm          , Sm          , Sm          , Sm          , Sm          , Sm          , Sm          , Rp^Vhcr     , Rd          , Rd          , Rd          , Ce          , Rd          , Rd          , Rd          , Rd          , Rd          , Dd          , Dd          , Dd          , Dd          , Dd          , Rd          , Rd          , Rd          , Rd          , Rd          , Rd          , Rd          , Rd          , Rd          , Rd          , Ce          , Ce          , Ce          , Dd          , Dd          , Hd          , Hd          
Sm          , Sm          , Sm          , Sm          , Sm          , Sm          , Sm          , Sm          , Rd          , Rp          , Rd          , Rd          , Rd          , Rd          , Rd          , Rd          , Dd          , Dd          , Dd          , Dd^Esd      , Dd          , Dd          , Dd          , Dd^Esd      , Dd^Esd      , Rd          , Rd          , Rd          , Dd          , Rd          , Dd          , Rd          , Dd          , Dd          , Dd          , Dd          , Dd          , Dd          , Dd^Vda      , Hd          
Sm          , Sm          , Sm          , Sm          , Sm          , Sm          , Sm          , Sm          , Rd          , Rp          , Rp          , Rd          , Rd          , Rd          , Rd          , Rd          , Dd          , Dd          , Hd          , Hd          , Dd          , Dd^Vdt      , Dd          , Dd          , Dd          , Dd          , Dd          , Dd          , Dd^Esd      , Dd          , Dd          , Dd          , Dd^Vda      , Dd          , Dd^Edp      , Dd          , Dd^Vdt      , Dd          , Dd          , Hd          
Sm          , Sm          , Sm          , Sm          , Sm          , Sm          , Sm          , Rd          , Rd          , Rd          , Rp          , Rd          , Rd          , Rd          , Dd          , Dd          , Hd          , Hd          , Hd          , Hd          , Hd          , Dd          , Dd          , Dd          , Hd          , Hd          , Hd          , Hd          , Hd          , Hd          , Rd          , Dd          , Rd          , Dd          , Rd          , Dd          , Dd          , Dd          , Hd          , Hd          
